000000000000+
022220000330+
021120000300+
021120033300+
022220030000+
000000330000+
000033300000+
000030022220+
003330021120+
003000021120+
033000022220+
000000000000
