2222000033+
2112000030+
2112003330+
2222003000+
0000033000+
0003330000+
0003002222+
0333002112+
0300002112+
3300002222+
